###########################
#>..F.#..F.#..F.#..F.#...#
#........................#
#........................#
###########################
