###########################
#>..#....#....#....#.....#
#........................#
#........................#
###########################
