##########
#>.......#
#........#
#........#
#........#
##########
