###################################
#>FFF.FFF.FFF.FFF.FFF.............#
#................................#
#................................#
###################################
