#############
#>7..........#
#...........#
#...........#
#...........#
#############
