#################
#..5............#
#...............#
#...............#
#...............#
#...............#
#>.............B#
#################
