#############
#>3..........#
#...........#
#...........#
#...........#
#############
