#################
#..5............#
#...............#
#...............#
#...............#
#>..............#
#..............B#
#################
