#################
#..5............#
#...............#
#>..............#
#...............#
#...............#
#..............B#
#################
