###################
#>12...............#
#.................#
#.................#
#.................#
###################
