############
#>.........#
#.###.###.#
#.#...#.#.#
#.#.###.#.#
#.#.....#.#
#.#####.#.#
#.......#.#
#.#####.#.#
#.......#F#
############
