######################
#>...................#
#.#####.###########.#
#.#...#...........#.#
#.#.###.#########.#.#
#.#.#.....#.....#.#.#
#.#.#.###.#.###.#.#.#
#.#.#.#...#.#.#.#.#.#
#.#.#.#####.#.#.#.#.#
#.#.#.......#.#.#.#.#
#.#.#########.#.#.#.#
#.#...........#.#.#.#
#.###########.#.#.#.#
#.............#.#.#.#
#.#############.#.#.#
#.................#F#
######################
