###############
#>............#
#.####.#####.#
#.#..#.#...#.#
#.#.##.#.###.#
#.#....#.....#
#.######.###.#
#......#.#...#
######.#.#.###
#......#.....#
#.######.###.#
#.#........#.#
#.#.######.#.#
#.#........#F#
###############
