#######################
#F#.........#...#...#>#
#.#.###.###.#.#.#.#.#.#
#.#.#...#.....#...#.#.#
#.###.#############.#.#
#...#.....#.......#.#.#
###.#.###.#.#.###.#.#.#
#...#.#...#.#...#.#.#.#
#.#####.#######.###.#.#
#.....#.#.....#...#.#.#
#####.#.#.###.#.#.#.#.#
#...#.#...#...#.#.#.#.#
###.#.###.#.###.#.#.#.#
#...#...#.#.#.#.#.#.#.#
#.#####.###.#.#.#.#.#.#
#...........#...#.....#
#######################