#############
#>......#...#
#######.###.#
#F....#...#.#
#####.###.#.#
#.......#.#.#
#.#####.#.#.#
#.#...#.#...#
#.#.#.#####.#
#...#...#...#
#.#####.#.###
#.....#.....#
#############