######################
#....................#
#....................#
#....................#
#....................#
#....................#
#....................#
#....................#
#....................#
#....................#
#.....#..............#
#....#.#.............#
#...#...#............#
#..#.....#...........#
#>#.....#.#.#........#
#....................#
#....................#
######################
