####################
#>.................#
###................#
#.###..............#
#...F..............#
#..###.............#
#.....############
#.................#
####################
