##########################
#........................#
#........................#
#........................#
#........................#
#........................#
#........................#
#........................#
#........................#
#........................#
#........................#
#........................#
#.......#................#
#......#.#...............#
#.....#...#..............#
#....#.....#.............#
#...#.......#............#
#..#.........#...........#
#>#.........#.#.#........#
#........................#
#........................#
##########################
