##############
#>...........#
#............#
#............#
#............#
#............#
##############
