####################################
#..................................#
#..................................#
#..................................#
#..................................#
#..................................#
#..................................#
#..................................#
#..................................#
#..................................#
#..................................#
#..................................#
#..................................#
#..................................#
#..................................#
#..................................#
#...........#......................#
#..........#.#.....................#
#.........#...#....................#
#........#.....#...................#
#.......#.......#..................#
#......#.........#.................#
#.....#...........#................#
#....#.............#...............#
#...#...............#..............#
#..#.................#.............#
#>#.................#.#.#..........#
#..................................#
#..................................#
####################################
