#########
#.......#
#>......#
#.......#
#.......#
#.......#
#.......#
#########
